1 37 2016 112 16 16 45 
2 37 2017 96 16 16 0 
3 2 2016 175 16 64 0 
4 2 2032 175 16 176 0 
5 2 2017 79 16 80 0 
6 2 1970 79 48 16 0 
7 2 1793 16 256 16 0 
8 2 1792 175 16 176 0 
9 2 1809 127 16 64 0 
10 2 1792 113 160 16 0 
11 14 1903 31 16 16 0 
12 15 1953 80 16 16 0 
13 14 1870 128 16 16 0 
14 9 1908 146 16 32 32 
15 4 1831 168 12 14 33 
16 12 1995 161 8 16 38 
17 12 1997 78 8 16 48 
18 12 1855 166 8 16 49 
19 2 2017 415 32 176 0 
20 2 2002 319 16 16 0 
21 15 1985 319 16 16 0 
22 37 1889 352 16 16 39 
23 2 1905 351 80 16 0 
24 2 1889 334 32 64 0 
25 2 1858 287 32 16 0 
26 2 1824 318 32 16 0 
27 2 1729 350 96 16 0 
28 2 1761 336 48 96 0 
29 2 1632 350 64 16 0 
30 2 1665 335 32 96 0 
31 2 1601 318 32 16 0 
32 2 1536 417 16 16 0 
33 10 1544 401 8 48 0 
34 2 1089 351 480 16 0 
35 2 1505 335 48 96 0 
36 2 1057 383 32 16 0 
37 2 799 383 32 16 0 
38 2 800 351 256 16 0 
39 2 768 415 32 176 0 
40 4 1896 410 12 14 31 
41 9 1864 326 16 32 33 
42 9 1655 390 16 32 32 
43 18 1599 350 32 8 0 
44 7 1115 395 16 16 31 
45 9 978 387 16 32 32 
46 12 1996 415 8 16 40 
47 12 1962 391 8 16 41 
48 12 1867 401 8 16 42 
49 12 1799 394 8 16 43 
50 12 1741 395 8 16 44 
51 12 1644 403 8 16 38 
52 12 1582 400 8 16 30 
53 12 1508 401 8 16 30 
54 12 1450 403 8 16 30 
55 12 1386 401 8 16 30 
56 12 1319 397 8 16 31 
57 12 1257 404 8 16 30 
58 12 1192 401 8 16 31 
59 12 1075 414 8 16 32 
60 12 1002 408 8 16 30 
61 12 937 406 8 16 30 
62 12 875 407 8 16 30 
63 14 816 399 16 16 0 
64 15 848 511 16 16 0 
65 37 1393 622 16 16 39 
66 2 865 510 32 16 0 
67 2 929 511 32 16 0 
68 2 991 527 64 16 0 
69 2 1088 527 64 16 0 
70 2 1120 591 32 16 0 
71 2 1345 559 32 16 0 
72 2 1249 591 96 16 0 
73 2 1377 623 16 16 0 
74 2 1185 527 320 16 0 
75 2 1409 591 96 16 0 
76 2 1505 656 32 176 0 
77 2 833 592 192 16 0 
78 37 704 559 16 16 0 
79 10 775 608 8 48 0 
80 2 800 559 32 16 0 
81 2 721 559 80 80 0 
82 2 672 543 48 64 0 
83 2 513 495 160 16 0 
84 2 481 527 32 48 0 
85 2 32 526 480 16 0 
86 2 129 543 32 16 0 
87 2 0 655 32 176 0 
88 2 193 575 32 16 0 
89 2 224 591 32 16 0 
90 2 256 623 480 16 0 
91 2 737 655 64 48 0 
92 14 160 559 16 16 0 
93 15 176 575 16 16 0 
94 14 656 639 16 16 0 
95 7 1167 580 16 16 32 
96 7 1097 549 16 16 31 
97 7 1034 570 16 16 33 
98 9 1261 561 16 32 32 
99 9 1288 624 16 32 33 
100 9 1463 633 16 32 34 
101 18 1214 590 32 8 0 
102 18 1084 589 32 8 0 
103 6 352 532 16 16 0 
104 6 483 631 16 16 0 
105 11 205 609 17 32 33 
106 11 319 657 17 32 33 
107 4 73 619 12 14 31 
108 12 875 556 8 16 30 
109 12 940 553 8 16 30 
110 12 1000 568 8 16 30 
111 12 1125 567 8 16 30 
112 12 1223 567 8 16 31 
113 12 1297 572 8 16 32 
114 12 1415 566 8 16 30 
115 12 1388 651 8 16 30 
116 12 1316 649 8 16 30 
117 12 1261 653 8 16 32 
118 12 1196 646 8 16 30 
119 12 1132 649 8 16 31 
120 12 998 645 8 16 30 
121 12 945 635 8 16 30 
122 12 874 642 8 16 30 
123 12 805 599 8 16 31 
124 12 648 570 8 16 30 
125 12 583 568 8 16 32 
126 12 523 572 8 16 30 
127 12 460 575 8 16 30 
128 12 395 570 8 16 30 
129 12 331 572 8 16 33 
130 12 262 556 8 16 30 
131 12 215 558 8 16 30 
132 12 132 604 8 16 30 
133 12 74 594 8 16 30 
134 2 721 768 16 16 0 
135 2 736 896 32 176 0 
136 15 704 768 16 16 0 
137 2 225 783 480 16 0 
138 2 0 895 16 160 0 
139 2 16 895 16 96 0 
140 2 0 768 224 16 0 
141 13 65 816 32 32 0 
142 7 288 849 16 16 31 
143 7 430 815 16 16 32 
144 12 651 839 8 16 30 
145 12 582 839 8 16 30 
146 12 519 840 8 16 30 
147 12 457 841 8 16 30 
148 12 394 839 8 16 30 
149 12 327 842 8 16 31 
150 12 250 838 8 16 32 
151 12 198 814 8 16 30 
152 46 1161 364 16 12 0 
153 35 426 798 16 16 0 
154 47 356 603 16 12 0 
155 47 420 604 16 12 0 
156 47 485 605 16 12 0