1 2 751 177 16 176 0 
2 2 736 177 16 96 0 
3 2 673 32 96 16 0 
4 2 129 16 640 16 0 
5 2 417 63 32 16 0 
6 2 304 63 16 16 0 
7 2 64 31 64 16 0 
8 2 33 64 32 16 0 
9 2 96 96 96 16 0 
10 2 0 176 32 176 0 
11 16 144 113 16 16 0 
12 17 62 272 16 16 0 
13 2 81 272 16 16 0 
14 2 0 416 32 176 0 
15 2 32 271 32 32 0 
16 2 129 336 32 32 0 
17 14 64 289 16 16 0 
18 15 112 336 16 16 0 
19 2 224 336 32 16 0 
20 2 160 272 160 16 0 
21 2 352 271 32 16 0 
22 2 417 303 32 16 0 
23 2 481 319 32 16 0 
24 2 448 271 32 16 0 
25 2 481 255 64 16 0 
26 2 545 335 32 16 0 
27 2 609 272 64 16 0 
28 2 672 287 32 16 0 
29 2 705 319 32 16 0 
30 14 384 289 16 16 0 
31 15 399 303 16 16 0 
32 17 576 335 16 16 30 
33 16 624 288 16 16 0 
34 2 737 415 32 64 0 
35 2 737 303 800 16 0 
36 2 737 288 32 48 0 
37 2 800 400 32 16 0 
38 2 1505 416 32 176 0 
39 2 1409 368 64 16 0 
40 14 1344 320 16 16 0 
41 15 1392 368 16 16 0 
42 16 1392 384 16 16 0 
43 17 1311 545 16 16 0 
44 2 1281 544 32 16 0 
45 2 1329 543 336 16 0 
46 2 1409 512 32 16 0 
47 2 1697 544 96 16 0 
48 2 1824 543 128 16 0 
49 2 1953 559 32 16 0 
50 10 752 353 8 48 0 
51 10 2032 624 8 48 0 
52 2 2016 655 32 32 0 
53 2 2049 639 32 16 0 
54 2 1985 575 16 16 0 
55 2 2001 575 816 16 0 
56 2 2017 560 32 80 0 
57 2 2848 575 32 16 0 
58 2 2912 575 32 16 0 
59 2 2977 575 352 16 0 
60 2 3200 512 32 16 0 
61 2 3264 656 32 32 0 
62 2 3361 543 16 16 0 
63 2 3377 527 0 0 0 
64 2 3264 559 96 16 0 
65 2 3264 543 32 64 0 
66 2 3329 495 256 16 0 
67 12 695 78 8 16 30 
68 12 621 47 8 16 30 
69 12 559 48 8 16 30 
70 12 513 48 8 16 30 
71 12 442 46 8 16 32 
72 12 381 46 8 16 30 
73 12 322 47 8 16 33 
74 12 254 50 8 16 30 
75 12 190 49 8 16 30 
76 12 128 65 8 16 30 
77 12 170 136 8 16 30 
78 6 658 65 16 16 33 
79 6 103 403 16 16 34 
80 12 156 380 8 16 30 
81 12 220 310 8 16 30 
82 12 296 305 8 16 30 
83 12 357 306 8 16 30 
84 12 420 335 8 16 30 
85 12 479 296 8 16 31 
86 12 533 296 8 16 33 
87 12 604 304 8 16 30 
88 12 670 303 8 16 32 
89 12 728 351 8 16 30 
90 12 798 366 8 16 30 
91 12 867 332 8 16 30 
92 7 1043 356 16 16 33 
93 7 1229 312 16 16 34 
94 12 1320 395 8 16 30 
95 12 1387 335 8 16 30 
96 12 1454 335 8 16 30 
97 12 1381 573 8 16 30 
98 12 1467 608 8 16 30 
99 12 1565 606 8 16 30 
100 11 1642 579 17 32 32 
101 11 1923 576 17 32 33 
102 12 1955 607 8 16 30 
103 12 2015 609 8 16 31 
104 12 2077 611 8 16 32 
105 11 2431 609 17 32 33 
106 11 2775 609 17 32 34 
107 7 3217 620 16 16 32 
108 11 3294 609 17 32 33 
109 12 3337 607 8 16 30 
110 12 3365 580 8 16 31 
111 12 3428 548 8 16 30 
112 12 3482 548 8 16 34 
113 12 3532 546 8 16 33 
114 21 424 79 16 16 32 
115 21 295 80 16 16 32 
116 21 168 112 16 16 34 
117 22 33 98 16 32 33 
118 22 361 306 16 32 34 
119 22 653 304 16 32 32 
120 22 2857 608 16 32 31 
121 22 2920 608 16 32 34 
122 23 272 398 16 12 31 
123 23 416 350 16 12 32 
123 23 480 383 16 12 33 
124 23 511 269 16 12 31 
126 23 1544 622 16 12 31 
127 23 1760 555 16 12 32 
128 23 1830 556 16 12 34 
129 23 2307 636 16 12 32 
130 23 2402 636 16 12 33 
131 23 2532 645 16 12 31 
132 23 2597 645 16 12 34 
133 23 2755 635 16 12 32 
134 24 3394 538 16 40 34 
135 24 3562 538 16 40 34 
136 37 288 65 16 16 39 
137 35 417 321 16 16 0 
138 22 1444 401 16 32 32 
139 7 1470 350 16 16 31 
140 35 1282 561 16 16 0 
141 35 3248 547 16 16 0 
142 37 3376 528 16 16 39 
